## Clases ##
Ultrasonic_UZI	KEYWORD1
Uzi	KEYWORD1
Motor	KEYWORD1
Buzzer	KEYWORD1
Control_BLE	KEYWORD1
Lights	KEYWORD1
Qre	KEYWORD1
Button	KEYWORD1
## metodos ##
init	KEYWORD2
read	KEYWORD2
evasor	KEYWORD2
seguidor	KEYWORD2
init	KEYWORD2
differentialFWD	KEYWORD2
forward	KEYWORD2
differentialBWD	KEYWORD2
backward	KEYWORD2
left	KEYWORD2
right	KEYWORD2
stop	KEYWORD2
init	KEYWORD2
update_state	KEYWORD2
action	KEYWORD2
off	KEYWORD2
init	KEYWORD2
r3d3	KEYWORD2
uzi	KEYWORD2
happy	KEYWORD2
scary	KEYWORD2
tatan	KEYWORD2
car	KEYWORD2
note	KEYWORD2
connection_standby	KEYWORD2
connected	KEYWORD2
disconnected	KEYWORD2
##control_BLE
updateStateBLEConection	KEYWORD2
updateStateMachine	KEYWORD2
updateStateUZI	KEYWORD2
updateStateDirection	KEYWORD2
updateStateAction	KEYWORD2
## Qre ##
readLine	KEYWORD2
## macros
BUTTONS	LITERAL1
RGB_LED_OUT	LITERAL1
RGB_LED_BACK	LITERAL1
RGB_LED_FRONT	LITERAL1 
BRIGHTNESS	LITERAL1
NUM_PIX	LITERAL1
MOTOR_A	LITERAL1
MOTOR_B	LITERAL1
STAND_BY_MOTOR	LITERAL1
PWM_MOTOR_A	LITERAL1
PWM_MOTOR_B	LITERAL1
TRG_R	LITERAL1
ECHO_R	LITERAL1
TRG_L	LITERAL1
ECHO_L	LITERAL1
IDLE	LITERAL1
DISCONNECTED 	LITERAL1
CONNECTED 	LITERAL1
STOP	LITERAL1
RUN	LITERAL1
MANUAL 	LITERAL1
AUTO 	LITERAL1
UP 	LITERAL1
URIGHT 	LITERAL1
RIGHT 	LITERAL1
DRIGHT	LITERAL1
DOWN	LITERAL1
DLEFT 	LITERAL1
LEFT 	LITERAL1
ULEFT 	LITERAL1
U 	LITERAL1
UR 	LITERAL1
R 	LITERAL1
DR 	LITERAL1
D 	LITERAL1
DL 	LITERAL1
L 	LITERAL1
UL 	LITERAL1
AUTO_ON 	LITERAL1
AUTO_OFF 	LITERAL1
K 	LITERAL1
EVATION	LITERAL1
FOLLOWER	LITERAL1
QREI 	LITERAL1
QREIC 	LITERAL1
QREC 	LITERAL1
QREDC 	LITERAL1
QRED 	LITERAL1
PIN_BUZZER	LITERAL1
DO	LITERAL1
DO_	LITERAL1
RE	LITERAL1
RE_	LITERAL1
MI	LITERAL1
FA	LITERAL1
FA_	LITERAL1
SOL	LITERAL1
SOL_	LITERAL1
LA	LITERAL1
LA_	LITERAL1
SI	LITERAL1